Level 2
8 8
++++++++
+a  bbb+
+a  d c+
+ **dec@
+jjj ec+
+  h ff+
+iihgg +
++++++++
