Initial level
8 8
++++++++
+aa bbb+
+   *  +
+d  * c+
+d fffc+
+de    +
+ e ggg+
++++@+++
