Level 1
8 8
++++++++
+aabbbc+
+d  * c+
+de *  +
+defff +
+      +
+   ggg+
++++@+++
