Level 1
8 8
++++++++
+aabbb +
+   *  +
+d  * c+
+d fffc+
+de    +
+ e ggg+
++++@+++
