Level 2
8 8
++++++++
+bbb   +
+a  d c+
+a**dec@
+jjj ec+
+  h ff+
+iihgg +
++++++++
