Level 1
8 8
++++++++
+aabbb +
+   *  +
+d  *  +
+d fffc+
+de   c+
+ e ggg+
++++@+++
