Level 1
8 8
++++++++
+aabbb +
+   * c+
+d  * c+
+d fff +
+de    +
+ e ggg+
++++@+++
