Level 1
8 8
++++++++
+aabbbc+
+d  * c+
+d  *  +
+d fff +
+ e    +
+ e ggg+
++++@+++
